wwwwwwwwwwwwwwwwwwwwwwwww
wwwswwwwww....sss...ww..w
ww...s...............C.Kw
wQ..................ffffw
wwf.................ssssw
w......s................w
wffffffw........ff......w
ws......fff..............
Y........D..............f
....s...fff............fw
...swfssw..............ww
sssw..ww...............BU
www...................fff
........................w
........................w
f.......................w
w...............f.......w
w..............fw.......w
w.....fff......wfs......w
w...............w......sw
w...............w.......w
w...............w.......w
w...............w.......w
R..............sw....fffw
wfllllllllllfffwwlllfwwww