wwwwwwwwwwwwwww
w         w   Y
w         w fff
w KB      w
wfff      w
w         w   f
w         w   w
w         w   w
w   f     D  Uw
         fffffw
ff         wssw
w             w
w             w
w        ssf  R
wffffffffwwwffw